יש כח - יש עבודה
יש עבודה - יש כסף.
יש כסף - יש אישה
יש  אישה - אין כח.
אין כח - אין עבודה
אין עבודה - אין כסף,
אין כסף - אין אישה
אין אישה- יש כח.
יש שמחה  - יש אהבה.
יש אהבה - יש חתונה.
יש חתונה - יש חותנת.
יש חותנת - אין שמחה.
אין שמחה - אין אהבה
אין אהבה - אין חתונה.
אין חתונה - אין חותנת.
אין חותנת - יש שמחה.
יש פיגורה - יש מחזרים.
יש מחזרים - יש בילויים.
יש בילויים -  יש ילדים.
יש ילדים - אין פיגורה.
אין פיגורה - אין מחזרים.
אין מחזרים - אין בילויים.
אין בילויים - אין ילדים.
אין ילדים - יש פיגורה.
יש קמח - יש תורה.
יש תורה -  יש ספרים.
יש ספרים - יש תולעים.
יש תולעים - אין קמח.
אין קמח - אין תורה.
אין תורה - אין ספרים.
אין ספרים - אין תולעים
אין תולעים - יש קמח.
