האמונה האמונה –מתעלה מעל לכל תמונה
בונה היא בית – כובשת עיר
כנגד כל הגיון סביר - פותחת פתח לכל אחד
לדעת שהוא מיוחד – אהה מיוחד- אהה מיוחד 
תשמעו סיפור מוסר גדול – עטלף ותרנגול
האחד הוא בעל קול קורא – השני רק שומע לא רואה
על ענף אחד ישבו שניהם - שח התרנגול בקול נרגש
אוך מתי כבר יפציע אור חדש - שהשחר יעלה – 
אוך אני כבר מצפה  
זאת העטלף שמע – וגם הוא אחריו מיד ענה
גם אני כמוך מתאווה נו שכבר יפציע אור חדש
גם אני כל כך כלכך נרגש 
שהשחר  כבר יעלה – גם אני כמוך מצפה  
התרנגול אמר סליחה – וצחק על הבדיחה
מה לעטלף ולזריחה – הרי מן האור אתה ירא
בכלל אתה גם לא רואה – תתקן אותי אם אני טועה
אהה אם אני טועה 
העטלף ענה בצ'יק – אני חוטא אתה צדיק
כי הנה מגיע יום עם אור חדש- 
ולכן אני כל כך  כל כך נרגש –
כך ענה העטלף – גם אותי הוא ילטף – אהה   
זה השיר מוסר ברור – לחכם וגם לבור
או-ו-ו-ור אור חדש מתגלה  – או – ור חדש בא ועולה
את כולנו ימלא- ותקן אותי אם אני טועה
תתקן אותי אם אני טועה – הצדיק והחוטא  
אהא  אהא
את כולנו יעורר- הפקח העיוור  
אור חדש שמתגלה
ותקן אותי אם אני טועה – אהא 
את כולנו יעורר הפקח העיוור
